NO ./path_to_the_north_texture
SO ./path_to_the_south_texture
WE ./path_to_the_west_texture
EA ./path_to_the_east_texture

C 0,0,255
F 0,255,0


     11111111111111111111111111111111
     10000000000000000000000000000111
     100000000000000000000000000001111111111
     100000000000111111110000000000000000001
     1000000000001      10000000000000000001
     1000000000001      10000000000000000001
     100000000000111111110000000000111111111
     100000000000000000000000000001
     100000000000000000000000000N01
     111111111111111111111111111111