NO ./xpm/texture1.xpm
SO ./xpm/texture2.xpm
WE ./xpm/texture3.xpm
EA ./xpm/onepiece.xpm

C 112,0,255
F 160,160,160


    11111111111111111111111111111111
     10000000000000000000000000000111
     100000000000000000000010001001111111111
     110000000000111111110010011100000000001
     1011111111101      10111011100100000001
     1000000000001      10111011100100000001
     100000000000111111110000000000111111111
     100000000000100000000000000001
     100000000000000010000000000S01
     111111111111111111111111111111