NO ./path_to_the_north_texture
SO ./path_to_the_south_texture
WE ./path_to_the_west_texture
EA ./path_to_the_east_texture

C 253,30,0
F 1,45,13

11111111111111
1N000000000001
10000000000001
10000100000101
10000010001001
10000000000001
11111111111111